

Afghanistan: ['Bricks']
Argentina: ['Garments']
Bangladesh: ['Dried Fish']
Benin: ['Cotton']
Bolivia: ['Brazil Nuts / Chestnuts', 'Sugarcane']
Burkina Faso: ['Cotton', 'Gold']
Burma: ['Bamboo', 'Beans', 'Bricks', 'Rice', 'Rubber', 'Sugarcane', 'Teak']
China: ['Bricks', 'Cotton', 'Electronics', 'Toys']
Colombia: ['Coca']
Cote D'Ivoire: ['Cocoa', 'Coffee']
Democratic Republic of the Congo: ['Cassiterite (tin ore)', 'Coltan (tantalum ore)', 'Gold', 'Wolframite (tungsten ore)']
Ethiopia: ['Textiles']
Ghana: ['Fish (Including Talapia)']
India: ['Bricks', 'Cottonseed (Hybrid)', 'Embellished Textiles', 'Garments', 'Rice', 'Stones']
Malawi: ['Tobacco']
Mali: ['Rice']
Nepal: ['Bricks', 'Carpets', 'Embellished Textiles', 'Stones']
Nigeria: ['Cocoa', 'Granite', 'Gravel']
Pakistan: ['Bricks', 'Carpets', 'Coal']
Russia: ['Pornography']
Sierra Leone: ['Diamonds']
South Sudan: ['Cattle']
Tajikstan: ['Cotton']
Thailand: ['Garments', 'Shrimp']
Uzbekistan: ['Cotton']
Vietnam: ['Garments']


Bricks: ['Afghanistan', 'Burma', 'China', 'India', 'Nepal', 'Pakistan']
Garments: ['Argentina', 'India', 'Thailand', 'Vietnam']
Dried Fish: ['Bangladesh']
Cotton: ['Benin', 'Burkina Faso', 'China', 'Tajikstan', 'Uzbekistan']
Brazil Nuts / Chestnuts: ['Bolivia']
Sugarcane: ['Bolivia', 'Burma']
Gold: ['Burkina Faso', 'Democratic Republic of the Congo']
Bamboo: ['Burma']
Beans: ['Burma']
Rice: ['Burma', 'India', 'Mali']
Rubber: ['Burma']
Teak: ['Burma']
Electronics: ['China']
Toys: ['China']
Coca: ['Colombia']
Cocoa: ["Cote D'Ivoire", 'Nigeria']
Coffee: ["Cote D'Ivoire"]
Cassiterite (tin ore): ['Democratic Republic of the Congo']
Coltan (tantalum ore): ['Democratic Republic of the Congo']
Wolframite (tungsten ore): ['Democratic Republic of the Congo']
Textiles: ['Ethiopia']
Fish (Including Talapia): ['Ghana']
Cottonseed (Hybrid): ['India']
Embellished Textiles: ['India', 'Nepal']
Stones: ['India', 'Nepal']
Tobacco: ['Malawi']
Carpets: ['Nepal', 'Pakistan']
Granite: ['Nigeria']
Gravel: ['Nigeria']
Coal: ['Pakistan']
Pornography: ['Russia']
Diamonds: ['Sierra Leone']
Cattle: ['South Sudan']
Shrimp: ['Thailand']